111111
100101
101001
1100E11
111111