NO ./assets/test1.xpm
SO ./assets/floor.xpm
WE ./assets/wall.xpm
EA ./assets/void.xpm
F 220,100,0
C 225,25,0

     11111111111111111
     1000000001       
     1000011111       
     100001           
1111110000111111111111
1111110000000000000001
1000000111111000111101
10000001    1000100001

10000001    1000100001
1111111111111111111111
1111111111111111111111
10W00001111 1000100001
10000000001 1111111111
11111111111