NO ./assets/test1.xpm
SO ./assets/floor.xpm
WE ./assets/wall.xpm
EA ./assets/void.xpm
F 220,100,0
C 225,30,0



11111111
10100101
10000101
10010001
10000001
100N0001
10010001
11111111








