11111111
1N000001
10000001
10000001
11111111