NO ./assets/Metal_Floor_64x64.xpm
SO ./assets/Magma_Floor_64x64.xpm
WE ./assets/Glowing_Square_Tile_64x64.xpm
EA ./assets/Wooden_Floor_Vertical_64x64.xpm
F 220,100,0
C 225,30,0



11111111   11111
11010101   10101
10010001   10001
10000001   10001
1000000111110001
100N000000000001
1100000000000001
1111111111111111








