NO ./assets/Metal_Floor_64x64.xpm
SO ./assets/Magma_Floor_64x64.xpm
WE ./assets/Glowing_Square_Tile_64x64.xpm
EA ./assets/Wooden_Floor_Vertical_64x64.xpm
F 220,100,0
C 225,30,0



1111111111111111
1101010101010101
1001000100010001
1000000100010001
1000000000000001
100N000000000001
1100000000000001
1111111111111111





