NO ./assets/north.xpm
SO ./assets/floor.xpm
WE ./assets/wall.xpm
EA ./assets/void.xpm
F 220,100,0
C 225,30,0



11111111
11001011
10001001
10000001
10000001
100N0001
11000011
11111111








