     1111111111       
     1000000001       
     1000011111       
     100001           
     10000111111111111
1111110000000000000001
1000000111111000111101
10000001    1000100001
10000001    1000100001
10000001111 1000100001
10E00000001 1111111111
11111111111