NO NORTE
SO SUL
WE OESTE
EA ESTE
S  YES
F 220,100,0
C 225,30,0



11111111
10000001
10111001
100N1001
10011001
10000001
11111111







