NO ./assets/Metal_Floor_64x64.xpm
SO ./assets/Magma_Floor_64x64.xpm
WE ./assets/Glowing_Square_Tile_64x64.xpm
EA ./assets/Wooden_Floor_Vertical_64x64.xpm
F 197,174,150
C 198,226,255



1111111111111111
1100010000000101
1100000111110001
1100100111110001
1100100111110001
11N0100000000001
1100100000000001
1111111111111111


